tests/tmp/7_check_easy_path.txt
#########
#O.....X#
# # ### #
# # # # #
# # # # #
# # # # #
# # # # #
#   #   #
#########
===EOF===
