#########
#       #
# # ### #
# # # # #
# # # # #
# # # # #
# # # # #
#   #   #
#########
