#########
#########
# # ### #
# # # # #
# # # # #
# # # # #
# # # # #
#   #   #
#########
