Невозможно найти маршрут
#########
#O#    X#
### ### #
# # # # #
# # # # #
# # # # #
# # # # #
#   #   #
#########
