#########
# #     #
### ### #
# # # # #
# # # # #
# # # # #
# # # # #
#   #   #
#########
